"filename", "language", "CMake", "C++", "JSON", "comment", "blank", "total"
"/home/okinai/Code/oki-bank/CMakePresets.json", "JSON", 0, 0, 52, 0, 1, 53
"/home/okinai/Code/oki-bank/cmake/info.cmake", "CMake", 30, 0, 0, 0, 0, 30
"/home/okinai/Code/oki-bank/include/sqlite3/sqlite3.h", "C++", 0, 1677, 0, 11211, 319, 13207
"/home/okinai/Code/oki-bank/src/app_init.hxx", "C++", 0, 28, 0, 0, 8, 36
"/home/okinai/Code/oki-bank/src/cache/base_cache_heap.cxx", "C++", 0, 54, 0, 0, 15, 69
"/home/okinai/Code/oki-bank/src/cache/base_cache_heap.hxx", "C++", 0, 33, 0, 0, 14, 47
"/home/okinai/Code/oki-bank/src/cache/cache_controller.cxx", "C++", 0, 13, 0, 0, 4, 17
"/home/okinai/Code/oki-bank/src/cache/cache_controller.hxx", "C++", 0, 17, 0, 0, 9, 26
"/home/okinai/Code/oki-bank/src/cache/cache_iterator.cxx", "C++", 0, 33, 0, 0, 11, 44
"/home/okinai/Code/oki-bank/src/cache/cache_iterator.hxx", "C++", 0, 19, 0, 0, 14, 33
"/home/okinai/Code/oki-bank/src/cache/std_cache_controller.cxx", "C++", 0, 57, 0, 0, 12, 69
"/home/okinai/Code/oki-bank/src/cache/std_cache_controller.hxx", "C++", 0, 23, 0, 0, 13, 36
"/home/okinai/Code/oki-bank/src/database/sqldb.cxx", "C++", 0, 5, 0, 0, 1, 6
"/home/okinai/Code/oki-bank/src/database/sqldb.hxx", "C++", 0, 30, 0, 1, 10, 41
"/home/okinai/Code/oki-bank/src/database/sqlite/exceptions/sqlite_exception.cxx", "C++", 0, 9, 0, 0, 4, 13
"/home/okinai/Code/oki-bank/src/database/sqlite/exceptions/sqlite_exception.hxx", "C++", 0, 15, 0, 0, 6, 21
"/home/okinai/Code/oki-bank/src/database/sqlite/sqlite3_db.cxx", "C++", 0, 71, 0, 0, 27, 98
"/home/okinai/Code/oki-bank/src/database/sqlite/sqlite3_db.hxx", "C++", 0, 16, 0, 0, 5, 21
"/home/okinai/Code/oki-bank/src/database/sqlite/sqlite3_rstmt.cxx", "C++", 0, 22, 0, 0, 8, 30
"/home/okinai/Code/oki-bank/src/database/sqlite/sqlite3_rstmt.hxx", "C++", 0, 15, 0, 0, 7, 22
"/home/okinai/Code/oki-bank/src/database/sqlsettings.hxx", "C++", 0, 7, 0, 0, 4, 11
"/home/okinai/Code/oki-bank/src/database/sqlstmt.cxx", "C++", 0, 14, 0, 0, 5, 19
"/home/okinai/Code/oki-bank/src/database/sqlstmt.hxx", "C++", 0, 22, 0, 0, 10, 32
"/home/okinai/Code/oki-bank/src/database/sqlstmt_exception.cxx", "C++", 0, 9, 0, 0, 4, 13
"/home/okinai/Code/oki-bank/src/database/sqlstmt_exception.hxx", "C++", 0, 15, 0, 0, 7, 22
"/home/okinai/Code/oki-bank/src/main.cxx", "C++", 0, 14, 0, 0, 5, 19
"/home/okinai/Code/oki-bank/src/models/private_account_info.cxx", "C++", 0, 15, 0, 0, 5, 20
"/home/okinai/Code/oki-bank/src/models/private_account_info.hxx", "C++", 0, 16, 0, 0, 7, 23
"/home/okinai/Code/oki-bank/src/models/private_user.cxx", "C++", 0, 56, 0, 0, 9, 65
"/home/okinai/Code/oki-bank/src/models/private_user.hxx", "C++", 0, 32, 0, 0, 10, 42
"/home/okinai/Code/oki-bank/src/models/public_account_info.cxx", "C++", 0, 15, 0, 0, 5, 20
"/home/okinai/Code/oki-bank/src/models/public_account_info.hxx", "C++", 0, 16, 0, 0, 7, 23
"/home/okinai/Code/oki-bank/src/models/public_user.cxx", "C++", 0, 45, 0, 0, 10, 55
"/home/okinai/Code/oki-bank/src/models/public_user.hxx", "C++", 0, 31, 0, 0, 10, 41
"/home/okinai/Code/oki-bank/src/models/transaction.cxx", "C++", 0, 25, 0, 0, 8, 33
"/home/okinai/Code/oki-bank/src/models/transaction.hxx", "C++", 0, 21, 0, 0, 7, 28
"/home/okinai/Code/oki-bank/src/models/user_status.hxx", "C++", 0, 11, 0, 0, 5, 16
"/home/okinai/Code/oki-bank/src/thread/okijthread.cxx", "C++", 0, 9, 0, 0, 1, 10
"/home/okinai/Code/oki-bank/src/thread/okijthread.hxx", "C++", 0, 16, 0, 0, 5, 21
"/home/okinai/Code/oki-bank/src/thread/okimutex.cxx", "C++", 0, 16, 0, 0, 7, 23
"/home/okinai/Code/oki-bank/src/thread/okimutex.hxx", "C++", 0, 14, 0, 0, 2, 16
"Total", "-", 30, 2556, 52, 11212, 621, 14471